GGGGGGGGGGGGGGGGGGGGGGGGGGGGBBGGGGGGCGGGGG
GGGGGGGGGGGGGGGGGGGGGGGGGGGGBBGGGGGGCGGGGG
GGGGGGGGGGGGGGGGGGGGGGGGGGGGBBGGGGGGCGGGGG
GGGGGGGGGGGGGGGGGGGGGGGGGGGGBBGGGGGGCGGGGG
GGGGGGGGGGGGGGGGGGGGGGGGGGGGBBGGGGGGCGGGGG
CCCCCCCCCCCCCCCCCCCCCCCCCCCCBBCCCCCCCGGGGG
GGGGGGGGGGGGGGGGGGGGGGGGGGGGBBGGGCGGGGGGGG
BBBBBBBBBBBBBBBBBBBBBBBBBBBBBBGGGCGGGGGGGG
BBBBBBBBBBBBBBBBBBBBBBBBBBBBBBGGGCGGGGGGGG
GGGGGGGGGGGGGGGGGGGGGGGGGGGGBBGGGCGGGGGGGG
DDGGGGGGGGGGGGGGGGGGGGGGGGGGBBGGGCGGGGGGGG
DDDDGGGGGGGGGGGGGGGGGGGGGGGGBBGGGCGGGGGGGG
DDDDDGGGGGGBBBBBBBBBBBBBBBBBBBBBBBBBBBBBBB
DDDDDDGGGGGGGGGGGGGGBGGGGGGGGGGGGCGGGGBBGG
DDDDDDDDGGGGGGGGGGGGBGGGGGGGGGGGGCGGGGBBGG
DDDDDDDDDDGGGGGGGGGGBGGGGGGGGGGGGCGGGGBBGG
DDDDCCCCCCCCCCCCCCCCBGGGGGGGGGGGGCGGGGBBGG
DDDDDDDDDGGGGGGGGGGGBGGGGGGGGGSSSCSSGGBBGG
DDDDDDDGGGGGGGGGGGGGBGGGGGGGGGSSSCSSGGBBGG
DDDDDGGGGGGGGGGGGGGGBGGGGGGGGGSSSCSSSSSSSS
DDGGGGGGGGGGGGGGGGGGBBBBBBBCCCCCCCSSSSSSSS
GGGGGGGGGGGGGGGGGGGGGGGGGBBGGGGGSSSSSSSSSS
GGGGGGGGGGGGGGGGGGGGGGGGGBBGGGGGSSSSSSSSSS
GGGGGGGGGGGGGGGGGGGGGGGGGGGGGGGGSSSSSSSSSS